 #   #X###
 #  O#  # 
    O  #  
#### #  X#
# #     ##
#    O  X#
######   #
##        
    ####  
    # #  #
