 #  ###   
   OO     
 #  ##    
    #X## #
### #X#  #
      #   
      ##  
####  #  #
        # 
##### ####
